1111111111111111111
1D000000C00000D1111
1001011111000001111
10010000C0000P01111
1001000000000ED1111
10001111101100000C1
1111111111111111111