11111111111111111111
1100E0C10CC000001111
1P000C0CC00000000001
11111111111111111111