1111111111
1PCE000001
10000000F1
1111111111