11111111111111111111
1100E0C10CC00D0D1111
1P000C0CC00D00000D01
11111111111111111111