11111111111111111111
1100E0C10CC000001111
1P000C0CC000D0000001
10000C0CC0000000D001
10000C0DC000000D0001
1000000CC000000000D1
100D000CC0000000DDD1
11111111111111111111