111111111
1110E11C1
101001001
101001001
100000001
100000001
1110C0001
100000001
1C1C1C101
100C0C001
110101CC1
100C00001
1110CC001
100010001
100C1C1C1
1C001C101
1C001C1C1
10C0C0C01
1000C0001
111100001
10C00C001
100001111
100000001
101101101
101000101
101000101
1C11P01C1
111111111